NO   ./textures/moss_wall_dark.xpm
WE ./textures/pixelwall.xpm
EA ./textures/testwall.xpm
SO ./textures/Tile_15.xpm

F 200, 200 ,240
C 240 ,200,240

 1111111 1 11
10000000101001
10000010000001
100001S1000001
10000010000001
1111111111111