NO ./textures/Tile_07.xpm
WE ./textures/Tile_20.xpm
EA ./textures/Tile_20.xpm
SO ./textures/Tile_07.xpm

F 200,200,240
C 240,200,240

1 11 1 1 1 1 1
11001010101011
10N00000000001
11111111111111