NO ./textures/Bricks_05.xpm
WE ./textures/Bricks_05.xpm
EA ./textures/Bricks_05.xpm
SO ./textures/Bricks_05.xpm

F 200,200,240
C 240,200,240

 1111111 1 11
100000001010E1
10000000000001
10000000000001
10000000000001
1111111111111