NO ./textures/DOOM/SKULWALL.xpm
WE ./textures/DOOM/SKSPINE1.xpm
EA ./textures/DOOM/MARBLE2.xpm
SO ./textures/DOOM/STARG3.xpm

F 20,25,20
C 20,20,25

11111111111111111111
10000000000000000001
10000000N00000000001
11111111111111111111