NO ./textures/DOOM/SKULWALL.xpm
WE ./textures/DOOM/SKSPINE1.xpm
EA ./textures/DOOM/MARBLE2.xpm
SO ./textures/DOOM/STARG3.xpm

F 20,25,20
C 20,20,25

1111111111111111111111111111
1000000000100000000000000001
1111110000010000000000101011
1000000000000000000000010001
1000000000000000000000000001
1000000000100000000000000001
100000000010000000000E000001
1000000000100000000000000001
1000000000100000000000000001
1000000000000001111111000001
1000000000000001     1000001
1000000000000001111111000001
1000000000000000000000000001
1000000000100000000000000001
1000000000100000000000000001
1000000000100000000000000001
1111111111111111111111111111