NO ./textures/moss_wall_dark.xpm
SO ./textures/colourful_wall.xpm
EA ./textures/testwall.xpm
WE ./textures/colourful_wall.xpm

F 20,0,20
C 20,0,20

1111111111111111111111111111
1000000000100000000000000001
1111110000010000000000001011
1000000000000000000000000001
100000000000000000000W000001
1000000000100000000000000001
1000000000100000000000000001
1000000000100000000000000001
1111111111111111111111111111