NO ./textures/moss_wall_dark.xpm
SO ./textures/colourful_wall.xpm
EA ./textures/testwall.xpm
WE ./textures/colourful_wall.xpm

F 255,0,31
C 45,67,99

111111111111111111111111111111111111111111111111111111111111
100000000010000000000000000000000000000000010000000000000001
111111000001000000000000000010111000000000111110000000000001
     1000001000000000000000011100000000000001100000000000001
     10000000000000111111111111000000N0000000000000000000001
     1000000000000011111111111100000000000000000000000000001
     1111111111111111111111111111111111111111111111111111111




