NO ./textures/testwall.xpm
WE ./textures/pixelwall.xpm
EA ./textures/colourful_wall.xpm
SO ./textures/moss_wall_dark.xpm

F 90,150,90
C 90,90,150

111111111111111111111111111
1000000000100000000000000001
1111110000010000000000000001
1000000000000000000001000001
100000000000000000001E100001
1000000000100000000001000001
1000000000100000000000000001
1000000000100000000000000001
1111111111111111111111111111