NO ./textures/WOLF3D/eagle.xpm
WE ./textures/WOLF3D/greystone.xpm
EA ./textures/WOLF3D/mossy.xpm
SO ./textures/WOLF3D/redbrick.xpm

F 90,150,90
C 90,90,150

1111111111111111111111111111
1000000000100000000000000001
1111110000010000000000101011
1000000000000000000000010001
100000000000000000000E000001
1000000000100000000000000001
1000000000100000000000000001
1000000000100000000000000001
1111111111111111111111111111